####################
#..................#
#..................#
#..@....#####......#
####################
