####################
#..................#
#..................#
#..@....##.........#
####################
