###############################################################################################################
#.............................................................................................................#
#.............................................................................................................#
#.............................................................................................................#
#.............................................................................................................#
#.............................................................................................................#
#.............................................................................................................#
#.............................................................................................................#
#.............................................................................................................#
#.............##..............................................................................................#
#..@....#.....................................................................................................#
###############################################################################################################
